2 13 31
###############################
#p   *  * *  1 * 2 *  * * *   #
# # # #*# # #*#*# # # #*#*#*# #
#*  *  b  ***  *  1   * 2 * * #
# # # # # #*# # #*#*# # # # #*#
#  s*   1 *   *  *  *   1  *  #
# # # # # # # # # #*# #*# # # #
#*  *  *   *  *   x  b   2 *  #
# # # # #*# # # #*#*# # # # # #
#*    f*  *  *1   *    *f  *  #
# #*# # # # # # #*# # # # # # #
#   *    *  *     s    *  *  x#
###############################